1111111111111
10P0100E00001
1000C00000101
10C0000C00101
1111111111111