1111111111111
1000100E00001
10P0C00000101
10C0000C00101
1111111111111